111111111111111111111111111111
100000000000000000000000000011
101111111111111111111111110011
1000C00000000E000000C0000001
11101111111111111111111111001
10000000000000000000000000001
10011111111111111111111111001
100000000000C0000000000000001
11111111111111111111111111111