11111111111111111111111111111
10000000000000000000000000001
10111111111111111111111111001
100000C0000P00000000000000001
11111111111111111111111111001
10000000000000001111111110001
10011111111111110000000000001
10000000000000010011111111101
11111111111111110100000000001
10000000000000000111111111101
11111111111111111111111111001
100000C0000000000000000000E11
11111111111111111111111111111