11111111111111111111111111111
10000000000000000000000000001
10111111111111111111111111001
100000C0000P00000000000000001
11111111111111111111111111001
10000000000000001111111110011
10011111111110110000000000001
10000000000000010011111111101
11111111110111110100000000001
10000000000000000111111111001
11111111111111111111111111001
100000E0000000000000000000111
11111111111111111111111111111