11111111111111111111
1P000000000000000111
1011000C000000000111
100001110001111C0E11
11111111111111111111