11111111111111
1P00000C000001
1000C000C00E01
11111111111111